{
"map":
{"BEL":{"x":2,"y":3},
"BGR":{"x":7,"y":6},
"CZE":{"x":4,"y":4},
"CYP":{"x":8,"y":7},
"DEU":{"x":4,"y":3},
"FRA":{"x":1,"y":4},
"HUN":{"x":5,"y":5},
"AUT":{"x":4,"y":5},
"DNK":{"x":4,"y":2},
"IRL":{"x":0,"y":2},
"ITA":{"x":2,"y":5},
"CRO":{"x":3,"y":6},
"ESP":{"x":1,"y":5},
"EST":{"x":6,"y":1},
"LUX":{"x":2,"y":4},
"FIN":{"x":6,"y":0},
"SWE":{"x":5,"y":0},
"POL":{"x":5,"y":3},
"ROU":{"x":6,"y":5},
"SVK":{"x":5,"y":4},
"SRB":{"x":6,"y":6},
"LIC":{"x":3,"y":4},
"CHE":{"x":2,"y":5},
"GBR":{"x":1,"y":2},
"ALB":{"x":5,"y":8},
"GRC":{"x":6,"y":8},
"LTU":{"x":6,"y":2},
"LVA":{"x":7,"y":2},
"PRT":{"x":0,"y":5},
"SVN":{"x":3,"y":6},
"NLD":{"x":3,"y":3},
"NOR":{"x":4,"y":0},
"MNE":{"x":5,"y":7},
"MKD":{"x":7,"y":7},
"BIH":{"x":5,"y":6}}
}
